type octile
height 20
width 20
key 16 4 13 10
key 17 8 1 15
map
@@@@@@@@@@@@@@@@@@@@
@..................@
@..................@
@..................@
@..................@
@..................@
@..................@
@..................@
@..................@
@..................@
@@@@@@@@@@@@@.@@@@@@
@..................@
@..................@
@..................@
@..................@
@.@@@@@@@@@@@@@@@@@@
@..................@
@..................@
@..................@
@..................@
@@@@@@@@@@@@@@@@@@@@